xdxxxxxxxxxxx
x           x
x xx xxx xx x
x x       x x
x x xxxxx x x
x   xd e  x x
x x     x   x
x x xxxxx x x
x x       x x
x xxx x xxd x
x           x
xxxxxxxxxxxxx
